The Prodigy - Voodoo People (Pendulum Remix).mp3	Abm
Radiohead - Idioteque.mp3	Eb
Roni Size & Reprazent - Brown Paper Bag.mp3	Em
Roots Manuva - Witness (1 Hope).mp3	Abm
Royksopp - Eple.mp3	Fm
Royksopp - The Girl And The Robot.mp3	Am
Saint Etienne - Only Love Can Break Your Heart.mp3	Dm
Shimon & Andy C - Bodyrock.mp3	Bm
Shy FX - On The Run.mp3	Bbm
Shystie - Nu Style (DeeKline & Ed Solo Mix).mp3	Em
SL2 - On A Ragga Tip.mp3	A
Souvlaki - Inferno.mp3	Em
Spor - Aztec.mp3	B
Squarepusher - My Red Hot Car.mp3	Gbm
Sub Focus - Triple X.mp3	Ebm
Substatic - Wild Horses.mp3	Em
Tori Amos - Professional Widow (Armand's Star Trunk Funkin' Mix).mp3	Dm
The Wiseguys - Ooh La La.mp3	Db
Wu-Tang Clan - Gravel Pit.mp3	Am
Xample - Keep Their Heads Ringing.mp3	Fm
Yelle - Je Veux Te Voir.mp3	Am
Acceptable In The 80s.mp3	E
All Good.mp3	Am
Animal Machine.mp3	Bbm
Bad Ass.mp3	Gm
Bad Girl (Roller Remix).mp3	Bbm
Barbra Streisand.mp3	Eb
Be True.mp3	Abm
Beautiful Lies (VIP Mix).mp3	Dm
Black Gloves.mp3	Em
Breathe.mp3	Ebm
Brighter Day.mp3	Gbm
Can't Get Enough.mp3	Dbm
Chase The Devil.mp3	Am
Circles (Album Edit).mp3	Dm
Clint Eastwood (Ed Case & Sweetie Irie Refix).mp3	Ebm
Concrete Schoolyard.mp3	C
Crazy In Love.mp3	Dm
Crunked Up.mp3	Gbm
Destroy Everything You Touch.mp3	Em
Dig Your Own Hole.mp3	Ebm
Doctor WHO.mp3	Em
Drop The Pressure.mp3	Em
Eastern Jam.mp3	Em
Evac Q 8.mp3	Abm
Flat Beat.mp3	Bm
Get Ur Freak On.mp3	Fm
Golddust.mp3	G
Happiness.mp3	Ab
Harder, Better, Faster, Stronger.mp3	Gbm
Hey Ya!.mp3	G
Higher State Of Consciousness (Tweekin' Acid Funk).mp3	G
Hip Hop.mp3	Am
I Feel Cream.mp3	Ebm
I Got 5 On It (Aphrodite's Original Dubplate).mp3	Bbm
I'm Back.mp3	Gm
Insomnia (Monster Mix).mp3	Bm
It's Time.mp3	Em
Just One Second (Apex Remix).mp3	Gbm
Katy On A Mission.mp3	Cm
Kiss Kiss Bang Bang.mp3	Gm
Milkshake (Freq Nasty's Hip Hall Mix).mp3	Dbm
Never Be Alone.mp3	Am
Nothing Left (Short Version).mp3	A
Out Of Space.mp3	Abm
People Everyday.mp3	Em
Phat Planet.mp3	Abm
Poison.mp3	E
Ready Or Not (DJ Zinc Remix).mp3	Am
Requiem.mp3	Gm
Ripgroove (Vocal Club Mix).mp3	Fm
Secret Agent.mp3	Bbm
Secret Life.mp3	Fm
Sexy Boy.mp3	Dm
Shake It (Philipe Boyar Remix).mp3	Fm
Shellshock.mp3	Fm
Smack My Bitch Up.mp3	Bbm
Song Of Life.mp3	Cm
Space Shanty.mp3	G
Steam.mp3	Bbm
Stigma.mp3	G
Straight Heat.mp3	Fm
Streetlife (feat. Takura).mp3	Dm
Streets Of Basra.mp3	Bm
Super Sharp Shooter.mp3	Gm
Sweet Love.mp3	Bb
Tarantula.mp3	Dm
Tear You Down.mp3	Ebm
The Lighter.mp3	Cm
The Sound Of The Big Babou.mp3	Bb
Thou Shalt Always Kill.mp3	Bbm
Thunder (Remix).mp3	Gbm
Toxic (Armand Van Helden Remix).mp3	Cm
Treat Me Better.mp3	Abm
Tribulations.mp3	Bm
Turbulence.mp3	Abm
Who Am I.mp3	Bm
Yeah.mp3	Dm
Yeah Yeah (D Ramirez Vocal Club Mix).mp3	C
